//map3
#pathX:0,1,1,4,4,8,8,9,9,12,12,15
#pathY:2,2,6,6,2,2,4,4,7, 7, 1, 1
#colors:0xffff00,0x222222,0x00aa00
//the map:16*10
1,1,1,2,2,2,1,1,1,1,1,1,1,1,1,1
1,1,1,2,1,1,1,1,1,2,2,2,0,0,0,0
0,0,1,1,0,0,0,0,0,1,1,2,0,1,1,1
1,0,1,1,0,1,1,1,0,2,1,1,0,1,1,1
1,0,1,1,0,2,2,2,0,0,1,1,0,1,1,1
1,0,1,1,0,2,1,1,1,0,1,1,0,1,1,1
1,0,0,0,0,1,1,1,1,0,1,1,0,1,1,1
1,1,1,1,1,1,2,1,1,0,0,0,0,2,1,1
2,1,1,1,2,2,2,1,1,1,1,2,2,2,1,1
2,2,2,1,1,1,1,1,1,1,1,1,1,1,1,1
//end map3